00000000000000000000
00000000000000000000
00011110000000000000
00010010000000000000
00010010000111111111
11110010000100000000
00000011111100000000
00000000000000000000
00000000000000000000
00000000000000000000
